0 0 0 0 0 0 0 0 0 0 0 0 0 0 0 0 0 0 0 0 0 0 0 0 0 0 0 0 0 0 0 0 
0 0 0 6 6 6 6 6 6 6 6 6 6 6 6 6 6 6 6 6 6 6 6 6 6 6 6 6 6 0 0 0 
0 0 0 6 4 4 4 4 4 4 4 4 4 4 4 4 4 4 4 4 4 4 4 4 4 4 4 4 6 0 0 0 
0 0 0 6 5 5 5 5 5 5 5 5 5 5 5 5 5 5 5 5 5 5 5 5 5 5 5 5 6 0 0 0
0 0 0 6 1 1 3 3 3 3 1 1 1 1 3 3 3 3 1 1 1 1 3 3 3 3 1 1 6 0 0 0 
0 0 0 6 1 2 3 3 3 3 2 2 2 2 3 3 3 3 2 2 2 2 3 3 3 3 2 1 6 0 0 0 
0 0 0 6 3 3 1 2 2 1 3 3 3 3 2 1 1 2 3 3 3 3 1 2 2 1 3 3 6 0 0 0 
0 0 0 6 3 3 2 3 3 2 3 3 3 3 1 3 3 1 3 3 3 3 2 3 3 2 3 3 6 0 0 0
0 0 0 6 3 3 2 3 3 2 3 3 3 3 1 3 3 1 3 3 3 3 2 3 3 2 3 3 6 0 0 0
0 0 0 6 3 3 1 2 2 1 3 3 3 3 2 1 1 2 3 3 3 3 1 2 2 1 3 3 6 0 0 0 
0 0 0 6 1 2 3 3 3 3 2 1 1 2 3 3 3 3 2 1 1 2 3 3 3 3 2 1 6 0 0 0 
0 0 0 6 1 2 3 3 3 3 1 3 3 1 3 3 3 3 1 3 3 1 3 3 3 3 2 1 6 0 0 0 
0 0 0 6 1 2 3 3 3 3 1 3 3 1 3 3 3 3 1 3 3 1 3 3 3 3 2 1 6 0 0 0 
0 0 0 6 1 2 3 3 3 3 2 1 1 2 3 3 3 3 2 1 1 2 3 3 3 3 2 1 6 0 0 0 
0 0 0 6 3 3 2 1 1 2 3 3 3 3 1 2 2 1 3 3 3 3 2 1 1 2 3 3 6 0 0 0 
0 0 0 6 3 3 1 3 3 1 3 3 3 3 2 3 3 2 3 3 3 3 1 3 3 1 3 3 6 0 0 0 
0 0 0 6 3 3 1 3 3 1 3 3 3 3 2 3 3 2 3 3 3 3 1 3 3 1 3 3 6 0 0 0 
0 0 0 6 3 3 2 1 1 2 3 3 3 3 1 2 2 1 3 3 3 3 2 1 1 2 3 3 6 0 0 0 
0 0 0 6 1 2 3 3 3 3 2 1 1 2 3 3 3 3 2 1 1 2 3 3 3 3 2 1 6 0 0 0 
0 0 0 6 1 2 3 3 3 3 1 3 3 1 3 3 3 3 1 3 3 1 3 3 3 3 2 1 6 0 0 0 
0 0 0 6 1 2 3 3 3 3 1 3 3 1 3 3 3 3 1 3 3 1 3 3 3 3 2 1 6 0 0 0 
0 0 0 6 1 2 3 3 3 3 2 1 1 2 3 3 3 3 2 1 1 2 3 3 3 3 2 1 6 0 0 0 
0 0 0 6 3 3 1 2 2 1 3 3 3 3 2 1 1 2 3 3 3 3 1 2 2 1 3 3 6 0 0 0 
0 0 0 6 3 3 2 3 3 2 3 3 3 3 1 3 3 1 3 3 3 3 2 3 3 2 3 3 6 0 0 0 
0 0 0 6 3 3 2 3 3 2 3 3 3 3 1 3 3 1 3 3 3 3 2 3 3 2 3 3 6 0 0 0 
0 0 0 6 3 3 1 2 2 1 3 3 3 3 2 1 1 2 3 3 3 3 1 2 2 1 3 3 6 0 0 0 
0 0 0 6 1 2 3 3 3 3 2 2 2 2 3 3 3 3 2 2 2 2 3 3 3 3 2 1 6 0 0 0 
0 0 0 6 1 1 3 3 3 3 1 1 1 1 3 3 3 3 1 1 1 1 3 3 3 3 1 1 6 0 0 0 
0 0 0 6 6 6 6 6 6 6 6 6 6 6 6 6 6 6 6 6 6 6 6 6 6 6 6 6 6 0 0 0 
0 0 0 4 4 4 4 4 4 4 4 4 4 4 4 4 4 4 4 4 4 4 4 4 4 4 4 4 4 0 0 0
0 0 0 5 5 5 5 5 5 5 5 5 5 5 5 5 5 5 5 5 5 5 5 5 5 5 5 5 5 0 0 0
0 0 0 0 0 0 0 0 0 0 0 0 0 0 0 0 0 0 0 0 0 0 0 0 0 0 0 0 0 0 0 0 